Ticker;SimFinId;Currency;"Fiscal Year";"Fiscal Period";"Report Date";"Publish Date";"Restated Date";"Shares (Basic)";"Shares (Diluted)";Revenue;"Cost of Revenue";"Gross Profit";"Operating Expenses";"Selling, General & Administrative";"Research & Development";"Depreciation & Amortization";"Operating Income (Loss)";"Non-Operating Income (Loss)";"Interest Expense, Net";"Pretax Income (Loss), Adj.";"Abnormal Gains (Losses)";"Pretax Income (Loss)";"Income Tax (Expense) Benefit, Net";"Income (Loss) from Continuing Operations";"Net Extraordinary Gains (Losses)";"Net Income";"Net Income (Common)"
1COV.DE;854465;EUR;2016;FY;2016-12-31;2017-02-15;2018-02-15;202500000;202500000;11904000000;-8611000000;3293000000;-2088000000;-1774000000;-259000000;;1331000000;-196000000;-114000000;1135000000;;1135000000;-329000000;806000000;;795000000;795000000
1COV.DE;854465;EUR;2017;FY;2017-12-31;2018-02-15;2019-02-15;202396416;202396416;14138000000;-9308000000;4830000000;-1962000000;-1833000000;-274000000;;2808000000;-150000000;-99000000;2658000000;;2658000000;-641000000;2017000000;;2009000000;2009000000
1COV.DE;854465;EUR;2018;FY;2018-12-31;2019-02-15;2020-02-15;192768826;192768826;14616000000;-9918000000;4698000000;-2052000000;-1899000000;-276000000;;2580000000;-104000000;-47000000;2476000000;;2476000000;-647000000;1829000000;;1823000000;1823000000
1COV.DE;854465;EUR;2019;FY;2019-12-31;2020-02-15;2021-02-15;182728724;182728724;12412000000;-9658000000;2754000000;-2083000000;-1752000000;-266000000;;852000000;-91000000;-45000000;761000000;;761000000;-204000000;557000000;;552000000;552000000
1COV.DE;854465;EUR;2020;FY;2020-12-31;2021-02-15;2022-02-15;182728724;182728724;10706000000;-8207000000;2499000000;-1866000000;-1505000000;-262000000;;696000000;-91000000;-47000000;605000000;;605000000;-151000000;454000000;;459000000;459000000
ADS.DE;847329;EUR;2016;FY;2016-12-31;2017-02-15;2018-02-15;200188276;206146908;18483000000;-9383000000;9100000000;-7885000000;;;;1582000000;-46000000;-46000000;1536000000;;1536000000;-454000000;1082000000;-62000000;1018000000;1018000000
ADS.DE;847329;EUR;2017;FY;2017-12-31;2018-02-15;2019-02-15;202391673;204240629;21218000000;-10514000000;10704000000;-8729000000;-8599000000;;;2107000000;-47000000;-47000000;2060000000;-37000000;2023000000;-668000000;1355000000;-254000000;1098000000;1098000000
ADS.DE;847329;EUR;2018;FY;2018-12-31;2019-02-15;2020-02-15;201759012;202044967;21915000000;-10552000000;11363000000;-9132000000;-9027000000;;;2408000000;10000000;10000000;2418000000;-41000000;2377000000;-669000000;1708000000;-5000000;1700000000;1700000000
ADS.DE;847329;EUR;2019;FY;2019-12-31;2020-02-15;2021-02-15;197606107;197606107;23640000000;-11347000000;12293000000;-9825000000;-9691000000;;;2678000000;-102000000;-102000000;2576000000;-18000000;2558000000;-640000000;1918000000;59000000;1975000000;1975000000
ADS.DE;847329;EUR;2020;FY;2020-12-31;2021-02-15;2022-02-15;195155924;195161729;18435000000;-9213000000;9222000000;-8469000000;-8353000000;;;856000000;-167000000;-167000000;689000000;-111000000;578000000;-117000000;461000000;-19000000;431000000;431000000
BAS.DE;854462;EUR;2016;FY;2016-12-31;2017-02-15;2018-02-15;918479000;919727891;57550000000;-39265000000;18285000000;-14097000000;-9101000000;-1863000000;;5968000000;-573000000;-482000000;5395000000;;5395000000;-1140000000;4255000000;;4056000000;4056000000
BAS.DE;854462;EUR;2017;FY;2017-12-31;2018-02-15;2019-02-15;918479000;919515885;61223000000;-41591000000;19632000000;-13937000000;-9512000000;-1843000000;;7264000000;-382000000;-315000000;6882000000;;6882000000;-1290000000;5592000000;760000000;6078000000;6078000000
BAS.DE;854462;EUR;2018;FY;2018-12-31;2019-02-15;2020-02-15;918479000;921135029;62675000000;-44319000000;18356000000;-14407000000;-10014000000;-2028000000;;5764000000;-476000000;-366000000;5288000000;;5288000000;-1138000000;4150000000;829000000;4707000000;4707000000
BAS.DE;854462;EUR;2019;FY;2019-12-31;2020-02-15;2021-02-15;918479000;920327869;59316000000;-43061000000;16255000000;-14414000000;-9222000000;-2158000000;;3936000000;-634000000;-465000000;3302000000;;3302000000;-756000000;2546000000;5945000000;8421000000;8421000000
BAS.DE;854462;EUR;2020;FY;2020-12-31;2021-02-15;2022-02-15;918479000;918479000;59149000000;-44040000000;15109000000;-16919000000;-8725000000;-2086000000;;-411000000;-1151000000;-373000000;-1562000000;;-1562000000;91000000;-1471000000;396000000;-1060000000;-1060000000
BAYN.DE;849702;EUR;2016;FY;2016-12-31;2017-02-15;2018-02-15;832502808;832502808;34943000000;-11756000000;23187000000;-18236000000;-12952000000;-4405000000;;5738000000;-965000000;-959000000;4773000000;;4773000000;-1017000000;3756000000;1070000000;4531000000;4531000000
BAYN.DE;849702;EUR;2017;FY;2017-12-31;2018-02-15;2019-02-15;872107808;872107808;35015000000;-11382000000;23633000000;-18594000000;-13142000000;-4504000000;;5903000000;-1326000000;-1346000000;4577000000;;4577000000;-1329000000;3248000000;4846000000;7336000000;7336000000
BAYN.DE;849702;EUR;2018;FY;2018-12-31;2019-02-15;2020-02-15;904754504;904754504;36742000000;-15381000000;21361000000;-22950000000;-14867000000;-5105000000;;3454000000;-1568000000;-1636000000;1886000000;;1886000000;-496000000;1390000000;321000000;1695000000;1695000000
BAYN.DE;849702;EUR;2019;FY;2019-12-31;2020-02-15;2021-02-15;981690000;981690000;43545000000;-17613000000;25932000000;-23406000000;-16095000000;-5301000000;;4162000000;-1309000000;-1469000000;2853000000;;2853000000;-443000000;2410000000;1700000000;4091000000;4091000000
BAYN.DE;849702;EUR;2020;FY;2020-12-31;2021-02-25;2022-02-15;981690000;981690000;41400000000;-19138000000;22262000000;-38431000000;-15932000000;-7126000000;;-16169000000;-1081000000;-985000000;-17250000000;;-17250000000;1689000000;-15561000000;5074000000;-10495000000;-10495000000
BEI.DE;854463;EUR;2016;FY;2016-12-31;2017-02-15;2018-02-15;226818984;226818984;6752000000;-2774000000;3978000000;-2963000000;-2771000000;-188000000;;1015000000;13000000;26000000;1028000000;12000000;1040000000;-313000000;727000000;;709000000;709000000
BEI.DE;854463;EUR;2017;FY;2017-12-31;2018-02-15;2019-02-15;226818984;226818984;7056000000;-2910000000;4146000000;-3058000000;-2866000000;-196000000;;1088000000;15000000;27000000;1103000000;-81000000;1022000000;-333000000;689000000;;672000000;672000000
BEI.DE;854463;EUR;2018;FY;2018-12-31;2019-02-15;2020-02-15;226818984;226818984;7233000000;-3075000000;4158000000;-3061000000;-2888000000;-211000000;;1097000000;14000000;26000000;1111000000;-63000000;1048000000;-303000000;745000000;;728000000;728000000
BEI.DE;854463;EUR;2019;FY;2019-12-31;2020-02-15;2021-02-15;226818984;226818984;7653000000;-3221000000;4432000000;-3400000000;-3082000000;-236000000;;1032000000;11000000;24000000;1043000000;-6000000;1037000000;-301000000;736000000;;718000000;718000000
BEI.DE;854463;EUR;2020;FY;2020-12-31;2021-02-15;2022-02-15;226818984;226818984;7025000000;-2984000000;4041000000;-3213000000;-2885000000;-246000000;;828000000;-7000000;20000000;821000000;;821000000;-244000000;577000000;;560000000;560000000
BMW.DE;825112;EUR;2016;FY;2016-12-31;2017-02-15;2018-02-15;656804571;656804571;94163000000;-75442000000;18721000000;-10005000000;-9158000000;;;9386000000;279000000;-293000000;9665000000;;9665000000;-2755000000;6910000000;;6863000000;6863000000
BMW.DE;825112;EUR;2017;FY;2017-12-31;2018-02-15;2019-02-15;657109486;657109486;98282000000;-78329000000;19953000000;-10774000000;-9560000000;;;9899000000;776000000;-211000000;10675000000;;10675000000;-2000000000;8675000000;;8589000000;8589000000
BMW.DE;825112;EUR;2018;FY;2018-12-31;2019-02-15;2020-02-15;657600576;657600576;96855000000;-78477000000;18378000000;-10219000000;-9568000000;;;8933000000;694000000;11000000;9627000000;;9627000000;-2530000000;7097000000;-33000000;6974000000;6974000000
BMW.DE;825112;EUR;2019;FY;2019-12-31;2020-02-15;2021-02-15;658118053;658118053;104210000000;-86147000000;18063000000;-11683000000;-9367000000;;;7411000000;-293000000;-320000000;7118000000;;7118000000;-2140000000;4978000000;44000000;4915000000;4915000000
BMW.DE;825112;EUR;2020;FY;2020-12-31;2021-02-15;2022-02-15;659040590;659040590;98990000000;-85408000000;13582000000;-9668000000;-8795000000;;;4830000000;392000000;-342000000;5222000000;;5222000000;-1365000000;3857000000;;3775000000;3775000000
BNTX;1212484;EUR;2018;FY;2018-12-31;2019-04-01;2021-03-30;211499000;211499000;127575000;-13690000;113885000;-167739000;-29375000;-143040000;;-53854000;6193000;6277000;-47661000;;-47661000;-600000;-48261000;;-48018000;-48018000
BNTX;1212484;EUR;2019;FY;2019-12-31;2020-03-31;2022-03-30;211499000;211499000;108600000;-17400000;91200000;-272700000;-48200000;-226500000;;-181500000;2099999;2099999;-179400001;;-179400001;200000;-179200001;;-179100001;-179100001
BNTX;1212484;EUR;2020;FY;2020-12-31;2021-03-30;2022-03-30;211499000;211499000;482300000;-59300000;423000000;-505400000;-108500000;-645000000;;-82400000;-63400000;-63400000;-145800000;;-145800000;161000000;15200000;;15200000;15200000
CON.DE;854464;EUR;2016;FY;2016-12-31;2017-02-15;2018-02-15;200000000;200000000;40549500000;-29783000000;10766500000;-7056900000;-3263600000;-2811500000;;4025600000;19900000;-207400000;4045500000;-66700000;3978800000;-1096800000;2882000000;;2802500000;2802500000
CON.DE;854464;EUR;2017;FY;2017-12-31;2018-02-15;2019-02-15;200000000;200000000;44009500000;-32635000000;11374500000;-7474800000;-3574500000;-3103700000;;4484200000;-248600000;-187100000;4235600000;40200000;4275800000;-1227500000;3048300000;;2984600000;2984600000
CON.DE;854464;EUR;2018;FY;2018-12-31;2019-02-15;2020-02-15;200000000;200000000;44404400000;-33299500000;11104900000;-8951000000;-3643300000;-4280200000;;3957300000;-113300000;-153300000;3844000000;5900000;3849900000;-891600000;2958300000;;2897300000;2897300000
CON.DE;854464;EUR;2019;FY;2019-12-31;2020-02-15;2021-02-15;200000000;200000000;44478400000;-33893400000;10585000000;-12504100000;-3829100000;-4471800000;;-144500000;-324400000;-170100000;-468900000;-119700000;-588600000;-582400000;-1171000000;;-1225000000;-1225000000
CON.DE;854464;EUR;2020;FY;2020-12-31;2021-02-15;2022-02-15;200000000;200000000;31864400000;-24370600000;7493800000;-9174800000;-3224900000;-3352800000;;-1681000000;993500000;-173500000;-687500000;71600000;-615900000;50300000;-565600000;-353200000;-961900000;-961900000
DAI.DE;825113;EUR;2016;FY;2016-12-31;2017-02-15;2018-02-15;1069800000;1069800000;153261000000;-121298000000;31963000000;-22200000000;-15645000000;-5257000000;;12113000000;461000000;-316000000;12574000000;;12574000000;-3790000000;8784000000;;8526000000;8526000000
DAI.DE;825113;EUR;2017;FY;2017-12-31;2018-02-15;2019-02-15;1069800000;1069800000;164154000000;-129626000000;34528000000;-23740000000;-16759000000;-5938000000;;13047000000;920000000;-368000000;13967000000;;13967000000;-3350000000;10617000000;;10278000000;10278000000
DAI.DE;825113;EUR;2018;FY;2018-12-31;2019-02-15;2020-02-15;1069800000;1069800000;167362000000;-134295000000;33067000000;-25146000000;-17103000000;-6581000000;;10251000000;344000000;-522000000;10595000000;;10595000000;-3013000000;7582000000;;7249000000;7249000000
DAI.DE;825113;EUR;2019;FY;2019-12-31;2020-02-15;2021-02-15;1069800000;1069800000;172745000000;-143580000000;29165000000;-27906000000;-16851000000;-6586000000;;4096000000;-266000000;-483000000;3830000000;;3830000000;-1121000000;2709000000;;2377000000;2377000000
DAI.DE;825113;EUR;2020;FY;2020-12-31;2021-02-18;2022-02-15;1069825436;1069825436;121778000000;-101592000000;20186000000;-16903000000;-11473000000;-4839000000;;5667000000;290000000;-134000000;5957000000;;5957000000;-1926000000;4031000000;-22000000;3627000000;3627000000
DB1.DE;854467;EUR;2016;FY;2016-12-31;2017-02-15;2018-02-15;186764058;186810215;2673900000;-585700000;2088200000;-1016900000;-285200000;;-131000000;1071300000;-39200000;-74600000;1032100000;;1032100000;-284500000;747600000;550600000;1272700000;1272700000
DB1.DE;854467;EUR;2017;FY;2017-12-31;2018-02-15;2019-02-15;186835673;186853039;2802500000;-340200000;2462300000;-1291500000;-650500000;;-159900000;1170800000;116600000;-79700000;1287400000;;1287400000;-391400000;896000000;;874300000;874300000
DB1.DE;854467;EUR;2018;FY;2018-12-31;2019-02-15;2020-02-15;184887281;184894886;3132400000;-352700000;2779700000;-1550700000;-824000000;;-210500000;1229000000;-72800000;-76400000;1156200000;;1156200000;-303700000;852500000;;824300000;824300000
DB1.DE;854467;EUR;2019;FY;2019-12-31;2020-02-15;2021-02-15;183381196;183384448;3315400000;-379400000;2936000000;-1490600000;-747800000;;-226200000;1445400000;-47400000;-53700000;1398000000;;1398000000;-362600000;1035400000;;1003900000;1003900000
DB1.DE;854467;EUR;2020;FY;2020-12-31;2021-02-15;2022-02-15;183381196;183381196;3756400000;-542600000;3213800000;-1633000000;-822900000;;-264300000;1580800000;-52600000;-76900000;1528200000;;1528200000;-403100000;1125100000;;1079900000;1079900000
DHER.DE;1087474;EUR;2016;FY;2016-12-31;2017-02-15;2018-02-15;171998900;171998900;289900000;-77200000;212700000;-374700000;-323500000;-31300000;;-159800000;-42400000;-33100000;-202200000;;-202200000;11000000;-191200000;-3600000;-194800000;-194800000
DHER.DE;1087474;EUR;2017;FY;2017-12-31;2018-02-15;2019-02-15;157734000;157734000;453700000;-173600000;280100000;-524400000;-476500000;-41100000;;-219300000;-91000000;-17900000;-310300000;-14600000;-324900000;-7500000;-332400000;-15700000;-348100000;-348100000
DHER.DE;1087474;EUR;2018;FY;2018-12-31;2019-02-15;2020-02-15;186169000;186169000;665100000;-318000000;347100000;-594600000;-531100000;-54300000;;-237500000;-17000000;2800000;-254500000;-4300000;-258800000;-18300000;-277100000;234800000;-42300000;-42300000
DHER.DE;1087474;EUR;2019;FY;2019-12-31;2020-02-15;2021-02-15;190355000;190355000;1237600000;-926400000;311200000;-970200000;-868700000;-94800000;;-639100000;-15400000;-9400000;-654500000;-8800000;-663300000;-26500000;-689800000;920200000;230400000;230400000
DHER.DE;1087474;EUR;2020;FY;2020-12-31;2021-04-28;2022-02-15;200534000;200534000;2471900000;-1977800000;494100000;-1368500000;-1247700000;-152300000;;-874400000;-498800000;-73200000;-1373200000;-19700000;-1392900000;-14200000;-1407100000;;-1407100000;-1407100000
DPW.DE;854468;EUR;2016;FY;2016-12-31;2017-02-15;2018-02-15;1203092606;1257325283;57334000000;-30620000000;26714000000;-25383000000;;;-1377000000;3487000000;-355000000;-294000000;3132000000;;3132000000;-351000000;2781000000;;2639000000;2639000000
DPW.DE;854468;EUR;2017;FY;2017-12-31;2018-02-15;2019-02-15;1210097823;1260834267;60444000000;-32775000000;27669000000;-25901000000;;;-1471000000;3739000000;-409000000;-393000000;3330000000;;3330000000;-477000000;2853000000;;2713000000;2713000000
DPW.DE;854468;EUR;2018;FY;2018-12-31;2019-02-15;2020-02-15;1230118545;1251910180;61550000000;-31673000000;29877000000;-28627000000;;;-3292000000;3164000000;-578000000;-549000000;2586000000;;2586000000;-362000000;2224000000;;2075000000;2075000000
DPW.DE;854468;EUR;2019;FY;2019-12-31;2020-02-15;2021-02-15;1234109757;1256971969;63341000000;-32070000000;31271000000;-29486000000;;;-3684000000;4136000000;-662000000;-652000000;3474000000;;3474000000;-698000000;2776000000;;2623000000;2623000000
DPW.DE;854468;EUR;2020;FY;2020-12-31;2021-02-15;2022-02-15;1234109757;1234109757;66716000000;-33704000000;33012000000;-30226000000;-22234000000;;-3830000000;4881000000;-710000000;-618000000;4171000000;;4171000000;-995000000;3176000000;;2979000000;2979000000
DRI.DE;936426;EUR;2017;FY;2017-12-31;2018-03-08;2019-02-15;;;2812313000;-1887695000;924618000;-484715000;-468135000;;;439903000;-8573000;-8573000;431330000;;431330000;-120959000;310371000;170931000;481302000;481302000
DRI.DE;936426;EUR;2018;FY;2018-12-31;2019-03-08;2019-03-08;;;3662460000;-2555662000;1106798000;-454352000;-503932000;;;652446000;-4652000;-4652000;647794000;-85219000;562575000;-156543000;406032000;0;406032000;406032000
DTE.DE;1099105;EUR;2016;FY;2016-12-31;2017-02-15;2018-02-15;4625000000;4625000000;73095000000;-34984000000;38111000000;-33127000000;-16463000000;;-13380000000;9164000000;-4617000000;-2492000000;4547000000;;4547000000;-1443000000;3104000000;;2675000000;2675000000
DTE.DE;1099105;EUR;2017;FY;2017-12-31;2018-02-15;2018-11-16;4703000000;4703000000;74947000000;-35848000000;39099000000;-33534000000;-15504000000;;-14586000000;9384000000;-4390000000;-2197000000;4994000000;;4994000000;558000000;5552000000;;3462000000;3462000000
DTE.DE;1099105;EUR;2018;FY;2018-12-31;2019-02-15;2021-02-15;4742000000;4742000000;75656000000;-35741000000;39915000000;-32892000000;-16436000000;;-13836000000;8514000000;-2848000000;-1817000000;5666000000;-514000000;5152000000;-1824000000;3328000000;;2165000000;2165000000
DTE.DE;1099105;EUR;2019;FY;2019-12-31;2020-02-15;2022-02-15;4743000000;4743000000;80531000000;-34509000000;46022000000;-37193000000;-16723000000;;-17663000000;9950000000;-2196000000;-2364000000;7754000000;-494000000;7260000000;-1993000000;5267000000;;3866000000;3866000000
DTE.DE;1099105;EUR;2020;FY;2020-12-31;2021-02-15;2022-02-15;4743000000;4743000000;100999000000;-41915000000;59084000000;-48107000000;-18853000000;;-25829000000;13856000000;-4127000000;-4224000000;9729000000;-1050000000;8679000000;-1929000000;6750000000;;4161000000;4161000000
DWNI.DE;1105024;EUR;2019;FY;2019-12-31;2020-02-15;2021-02-15;354530000;354530000;1478700000;-530400000;948300000;-312700000;-211600000;;-42900000;833300000;-155210000;-158010000;678090000;1426510000;2104600000;-503700000;1600900000;;1529500000;1529500000
DWNI.DE;1105024;EUR;2020;FY;2020-12-31;2021-02-15;2021-02-15;357087000;357087000;1483800000;-540600000;943200000;-319500000;-231800000;;-40000000;653800000;-152500000;-161400000;501300000;1742400000;2243700000;-699100000;1544600000;;1502700000;1502700000
EOAN.DE;854469;EUR;2016;FY;2016-12-31;2017-02-15;2018-02-15;1952000000;1952000000;38173000000;-32325000000;5848000000;-13992000000;-2839000000;;-3823000000;-696000000;-1029000000;-1638000000;-1725000000;;-1725000000;-440000000;-2165000000;-13842000000;-8450000000;-8450000000
EOAN.DE;854469;EUR;2017;FY;2017-12-31;2018-02-15;2019-02-15;2129000000;2129000000;37297000000;-29961000000;7336000000;-10495000000;-3033000000;;-1700000000;4212000000;748000000;-1337000000;4960000000;;4960000000;-803000000;4157000000;23000000;3925000000;3925000000
EOAN.DE;854469;EUR;2018;FY;2018-12-31;2019-02-15;2020-02-15;2167000000;2167000000;29396000000;-22635000000;6761000000;-8411000000;-2460000000;;-1575000000;3684000000;-400000000;-1236000000;3284000000;;3284000000;-46000000;3238000000;286000000;3223000000;3223000000
EOAN.DE;854469;EUR;2019;FY;2019-12-31;2020-02-15;2021-02-15;2293000000;2293000000;40803000000;-31434000000;9369000000;-13798000000;-4101000000;;-2489000000;938000000;-166000000;-1677000000;772000000;;772000000;-43000000;729000000;1063000000;1550000000;1550000000
EOAN.DE;854469;EUR;2020;FY;2020-12-31;2021-02-15;2022-02-15;2293000000;2293000000;60944000000;-47147000000;13797000000;-20229000000;-5866000000;;-4166000000;2475000000;-294000000;-1390000000;2181000000;;2181000000;-871000000;1310000000;-40000000;1017000000;1017000000
FMS;1108967;EUR;2016;FY;2016-12-31;2017-02-15;2019-02-15;611496762;611496762;16569715000;-10953769000;5615946000;-3279226000;-3132715000;-146511000;;2336720000;-304769000;-363408000;2031951000;13543000;2045494000;-625442000;1420052000;;1143980000;1143980000
FMS;1108967;EUR;2017;FY;2017-12-31;2018-02-15;2020-02-15;613126800;613126800;17783572000;-11765318000;6018254000;-3748777000;-3637780000;-110997000;;2269477000;-297625000;-364824000;1971852000;25763000;1997615000;-443081000;1554534000;;1279788000;1279788000
FMS;1108967;EUR;2018;FY;2018-12-31;2019-02-15;2021-02-15;613083412;613083412;16546873000;-11392130000;5154743000;-2999294000;-2885220000;-114074000;;2155449000;-227716000;-301062000;1927733000;809003000;2736736000;-511079000;2225657000;;1981924000;1981924000
FMS;1108967;EUR;2019;FY;2019-12-31;2020-02-15;2022-02-15;605382794;605382794;17476555000;-12080704000;5395851000;-3199972000;-3031944000;-168028000;;2195879000;-355765000;-429444000;1840114000;;1840114000;-401614000;1438500000;;1199619000;1199619000
FMS;1108967;EUR;2020;FY;2020-12-31;2021-02-15;2022-02-15;605382794;605382794;17859063000;-12321618000;5537445000;-3327554000;-3133780000;-193774000;;2209891000;-273501000;-368019000;1936390000;;1936390000;-500558000;1435832000;;1164377000;1164377000
FRE.DE;849704;EUR;2016;FY;2016-12-31;2017-02-15;2018-02-15;546395188;550084660;29471000000;-19958000000;9513000000;-5427000000;-4742000000;-528000000;;4302000000;-582000000;-582000000;3720000000;;3720000000;-1044000000;2676000000;;1560000000;1560000000
FRE.DE;849704;EUR;2017;FY;2017-12-31;2018-02-15;2019-02-15;554124656;557506980;33886000000;-23395000000;10491000000;-6295000000;-5554000000;-558000000;;4563000000;-667000000;-667000000;3896000000;26000000;3922000000;-889000000;3033000000;;1814000000;1814000000
FRE.DE;849704;EUR;2018;FY;2018-12-31;2019-02-15;2020-02-15;555543954;557304502;33530000000;-23696000000;9834000000;-5833000000;-4893000000;-653000000;;4442000000;-587000000;-587000000;3855000000;809000000;4664000000;-950000000;3714000000;;2027000000;2027000000
FRE.DE;849704;EUR;2019;FY;2019-12-31;2020-02-15;2021-02-15;556820762;557417314;35409000000;-25061000000;10348000000;-6177000000;-5406000000;-645000000;;4602000000;-719000000;-719000000;3883000000;29000000;3912000000;-883000000;3029000000;;1883000000;1883000000
FRE.DE;849704;EUR;2020;FY;2020-12-31;2021-02-15;2022-02-15;557451759;557743862;36277000000;-25961000000;10316000000;-5931000000;-5430000000;-751000000;;4385000000;-659000000;-659000000;3726000000;;3726000000;-903000000;2823000000;;1707000000;1707000000
HEI.DE;854470;EUR;2016;FY;2016-12-31;2017-02-15;2018-02-15;193023000;193023000;15127800000;-5873900000;9253900000;-7862200000;;;-958800000;1391700000;-243500000;-385400000;1148200000;;1148200000;-314300000;833900000;-3200000;656900000;656900000
HEI.DE;854470;EUR;2017;FY;2017-12-31;2018-02-15;2019-02-15;198416000;198416000;17314100000;-6781600000;10532500000;-8681300000;;;-1109000000;1851200000;-162700000;-305400000;1688500000;;1688500000;-579500000;1109000000;-50800000;917700000;917700000
HEI.DE;854470;EUR;2018;FY;2018-12-31;2019-02-15;2020-02-15;198416000;198416000;18152000000;-7478100000;10673900000;-8801500000;;;-1090500000;1872400000;-107800000;-271700000;1764600000;;1764600000;-464100000;1300500000;-14200000;1143100000;1143100000
HEI.DE;854470;EUR;2019;FY;2019-12-31;2020-02-15;2021-02-15;198416000;198416000;18939300000;-7586100000;11353200000;-9634900000;;;-1394000000;1718300000;-85500000;-264900000;1632800000;;1632800000;-358400000;1274400000;-32400000;1090700000;1090700000
HEI.DE;854470;EUR;2020;FY;2020-12-31;2021-02-15;2022-02-15;198416000;198416000;17564700000;-6482900000;11081800000;-12675400000;;;-1343900000;-1593600000;-9100000;-192900000;-1602700000;;-1602700000;-334500000;-1937200000;-72300000;-2139500000;-2139500000
HEN.DE;854471;EUR;2016;FY;2016-12-31;2017-02-15;2018-02-15;434278198;434278198;18714000000;-9742000000;8972000000;-6306000000;-5697000000;-463000000;;2775000000;-33000000;-5000000;2742000000;;2742000000;-649000000;2093000000;;2053000000;2053000000
HEN.DE;854471;EUR;2017;FY;2017-12-31;2018-02-15;2019-02-15;434278198;434278198;20029000000;-10680000000;9349000000;-6423000000;-5856000000;-476000000;;3055000000;-67000000;-37000000;2988000000;;2988000000;-447000000;2541000000;;2519000000;2519000000
HEN.DE;854471;EUR;2018;FY;2018-12-31;2019-02-15;2020-02-15;434278198;434278198;19899000000;-10743000000;9156000000;-6194000000;-5629000000;-484000000;;3116000000;-65000000;-61000000;3051000000;;3051000000;-721000000;2330000000;;2314000000;2314000000
HEN.DE;854471;EUR;2019;FY;2019-12-31;2020-02-15;2021-02-15;434278198;434278198;20114000000;-10883000000;9231000000;-6494000000;-5911000000;-499000000;;2899000000;-88000000;-75000000;2811000000;;2811000000;-708000000;2103000000;;2085000000;2085000000
HEN.DE;854471;EUR;2020;FY;2020-12-31;2021-02-15;2022-02-15;434278198;434278198;19250000000;-10378000000;8872000000;-6967000000;-6327000000;-501000000;;2020000000;-94000000;-41000000;1926000000;;1926000000;-501000000;1425000000;;1409000000;1409000000
IFX.DE;858321;EUR;2016;FY;2016-09-30;2016-11-16;2017-11-16;1125200000;1129300000;6473000000;-4143000000;2330000000;-1584000000;-791000000;-770000000;;763000000;-58000000;-61000000;705000000;;705000000;36000000;741000000;2000000;744000000;744000000
IFX.DE;858321;EUR;2017;FY;2017-09-30;2017-11-16;2018-11-16;1128600000;1133900000;7063000000;-4442000000;2621000000;-1652000000;-819000000;-776000000;;983000000;-50000000;-53000000;933000000;;933000000;-142000000;791000000;-1000000;790000000;790000000
IFX.DE;858321;EUR;2018;FY;2018-09-30;2018-11-16;2019-11-16;1130500000;1134100000;7599000000;-4714000000;2885000000;-1748000000;-850000000;-836000000;;1469000000;-58000000;-53000000;1411000000;;1411000000;-193000000;1218000000;-143000000;1075000000;1075000000
IFX.DE;858321;EUR;2019;FY;2019-09-30;2019-11-16;2020-11-16;1163400000;1164800000;8029000000;-5035000000;2994000000;-1889000000;-865000000;-945000000;;1161000000;-78000000;-72000000;1083000000;;1083000000;-194000000;889000000;-19000000;870000000;870000000
IFX.DE;858321;EUR;2020;FY;2020-09-30;2020-11-16;2021-11-16;1264500000;1265500000;8567000000;-5791000000;2776000000;-2271000000;-1042000000;-1113000000;;581000000;-157000000;-148000000;424000000;;424000000;-52000000;372000000;-4000000;368000000;736000000
MRK.DE;1117110;EUR;2016;FY;2016-12-31;2017-02-15;2018-02-15;434777878;434777878;15024000000;-5201000000;9823000000;-8337000000;-5380000000;-1976000000;;2482000000;-326000000;-326000000;2156000000;;2156000000;-521000000;1635000000;;1631000000;1631000000
MRK.DE;1117110;EUR;2017;FY;2017-12-31;2018-02-15;2019-02-15;434777878;434779027;14517000000;-5071000000;9446000000;-8236000000;-5248000000;-2108000000;;2422000000;-294000000;-294000000;2128000000;;2128000000;428000000;2556000000;57000000;2603000000;2603000000
MRK.DE;1117110;EUR;2018;FY;2018-12-31;2019-02-15;2020-02-15;434777878;434795802;14836000000;-5382000000;9454000000;-8381000000;-5579000000;-2227000000;;1700000000;-266000000;-266000000;1434000000;27000000;1461000000;-368000000;1093000000;2303000000;3374000000;3374000000
MRK.DE;1117110;EUR;2019;FY;2019-12-31;2020-02-15;2021-02-15;434777878;434777878;16152000000;-6006000000;10146000000;-8733000000;-5730000000;-2268000000;;2128000000;-384000000;-384000000;1744000000;-8000000;1736000000;-440000000;1296000000;28000000;1321000000;1321000000
MRK.DE;1117110;EUR;2020;FY;2020-12-31;2021-02-15;2022-02-15;434777878;434777878;17534000000;-6835000000;10699000000;-7708000000;-5395000000;-2288000000;;2991000000;-354000000;-354000000;2637000000;-6000000;2631000000;-637000000;1994000000;;1987000000;1987000000
MTX.DE;1117259;EUR;2016;FY;2016-12-31;2017-02-15;2018-02-15;51262220;53550600;4732700000;-4074800000;657900000;-253000000;-174800000;-71100000;;422100000;-6500000;-11900000;415600000;;415600000;-103000000;312600000;;312200000;312200000
MTX.DE;1117259;EUR;2017;FY;2017-12-31;2018-02-15;2019-02-15;51442495;54970930;3897400000;-3186500000;710900000;-241500000;-179000000;-51700000;;477300000;800000;-7200000;478100000;;478100000;-119400000;358700000;;355100000;355100000
MTX.DE;1117259;EUR;2018;FY;2018-12-31;2019-02-15;2020-02-15;51580929;55185185;4567100000;-3715800000;851300000;-285600000;-198700000;-60700000;;574700000;32600000;-700000;607300000;;607300000;-154000000;453300000;;447000000;447000000
MTX.DE;1117259;EUR;2019;FY;2019-12-31;2020-02-15;2021-02-15;51813526;55428007;4628000000;-3697000000;931000000;-321000000;-204000000;-66000000;;622000000;44000000;-17000000;666000000;;666000000;-178000000;488000000;;478000000;478000000
MTX.DE;1117259;EUR;2020;FY;2020-12-31;2021-02-15;2022-02-15;51813526;51813526;3977000000;-3484000000;493000000;-348000000;-225000000;-61000000;;193000000;3000000;-20000000;196000000;;196000000;-48000000;148000000;;140000000;140000000
RWE.DE;858324;EUR;2016;FY;2016-12-31;2017-02-15;2018-02-15;614745000;614745000;43590000000;-33397000000;10193000000;-15747000000;-4777000000;;-6647000000;-4119000000;-1688000000;-2228000000;-5807000000;;-5807000000;323000000;-5484000000;;-5651000000;-5710000000
RWE.DE;858324;EUR;2017;FY;2017-12-31;2018-02-15;2019-02-15;614745000;614745000;13822000000;-10029000000;3793000000;-5087000000;-1848000000;;-1330000000;1962000000;94000000;-63000000;2056000000;;2056000000;-333000000;1723000000;592000000;1942000000;1900000000
RWE.DE;858324;EUR;2018;FY;2018-12-31;2019-02-15;2020-02-15;614745000;614745000;13406000000;-9998000000;3408000000;-3749000000;-1895000000;;-948000000;289000000;-240000000;-409000000;49000000;;49000000;-103000000;-54000000;1127000000;394000000;335000000
RWE.DE;858324;EUR;2019;FY;2019-12-31;2020-02-15;2021-02-15;614745000;614745000;13125000000;-9078000000;4047000000;-8946000000;-2526000000;;-3166000000;-143000000;-609000000;-938000000;-752000000;;-752000000;92000000;-660000000;9816000000;8513000000;8498000000
RWE.DE;858324;EUR;2020;FY;2020-12-31;2021-02-15;2022-02-15;614745000;614745000;13688000000;-9814000000;3874000000;-7451000000;-2365000000;;-3136000000;1400000000;-135000000;-454000000;1265000000;;1265000000;-376000000;889000000;221000000;1051000000;1051000000
SAP.DE;858325;EUR;2016;FY;2016-12-31;2017-02-15;2019-02-15;1198000000;1199000000;22062000000;-6584000000;15478000000;-10317000000;-7270000000;-3044000000;;5161000000;-263000000;-29000000;4898000000;-28000000;4870000000;-1242000000;3628000000;;3641000000;3641000000
SAP.DE;858325;EUR;2017;FY;2017-12-31;2018-02-15;2020-02-15;1197000000;1198000000;23461000000;-7052000000;16409000000;-11350000000;-7999000000;-3352000000;;5059000000;152000000;188000000;5211000000;-182000000;5029000000;-983000000;4046000000;;4008000000;4008000000
SAP.DE;858325;EUR;2018;FY;2018-12-31;2019-02-15;2021-02-15;1194000000;1194000000;24708000000;-7462000000;17246000000;-11523000000;-7879000000;-3624000000;;5723000000;-103000000;-47000000;5620000000;-19000000;5601000000;-1511000000;4090000000;;4084000000;4084000000
SAP.DE;858325;EUR;2019;FY;2019-12-31;2020-02-15;2022-02-15;1194000000;1194000000;27553000000;-8355000000;19198000000;-13596000000;-9322000000;-4292000000;;5602000000;124000000;198000000;5726000000;-1130000000;4596000000;-1226000000;3370000000;;3320000000;3320000000
SAP.DE;858325;EUR;2020;FY;2020-12-31;2021-02-15;2022-02-15;1194000000;1194000000;27338000000;-7885000000;19453000000;-12832000000;-8462000000;-4454000000;;6621000000;597000000;776000000;7218000000;3000000;7221000000;-1938000000;5283000000;;5145000000;5145000000
SIE.DE;849707;EUR;2016;FY;2016-09-30;2016-11-16;2017-11-16;808686000;819914000;79644000000;-55826000000;23818000000;-16828000000;-11669000000;-4732000000;;7318000000;86000000;325000000;7404000000;;7404000000;-2008000000;5396000000;188000000;5450000000;5450000000
SIE.DE;849707;EUR;2017;FY;2017-09-30;2017-11-16;2018-11-16;812180000;829164000;82863000000;-57820000000;25043000000;-18119000000;-12360000000;-5164000000;;7571000000;617000000;439000000;8188000000;;8188000000;-2148000000;6040000000;53000000;5960000000;5960000000
SIE.DE;849707;EUR;2018;FY;2018-09-30;2018-11-16;2019-11-16;815063000;828316000;83044000000;-58181000000;24863000000;-19177000000;-12941000000;-5558000000;;6186000000;1864000000;392000000;8050000000;;8050000000;-2054000000;5996000000;124000000;5807000000;5807000000
SIE.DE;849707;EUR;2019;FY;2019-09-30;2019-11-16;2020-11-16;807273000;818309000;58483000000;-36849000000;21634000000;-15719000000;-10688000000;-4669000000;;6291000000;642000000;569000000;6933000000;;6933000000;-1775000000;5158000000;490000000;5174000000;5174000000
SIE.DE;849707;EUR;2020;FY;2020-09-30;2020-11-16;2021-11-16;806335000;817364000;55254000000;-35366000000;19888000000;-15647000000;-10682000000;-4569000000;;4871000000;631000000;731000000;5502000000;;5502000000;-1346000000;4156000000;44000000;4030000000;4030000000
VNA.DE;858328;EUR;2016;FY;2016-12-31;2017-02-15;2018-02-15;497082866;497082866;3437200000;-1081900000;2355300000;1821100000;;;-27000000;4281700000;-421900000;-421900000;3859800000;;3859800000;-1346900000;2512900000;;2340700000;2300700000
VNA.DE;858328;EUR;2017;FY;2017-12-31;2018-02-15;2019-02-15;508242979;508242979;3598000000;-1176400000;2421600000;1802300000;;;-372200000;4334600000;-306200000;-306200000;4028400000;-21000000;4007400000;-1440500000;2566900000;;2450700000;2410700000
VNA.DE;858328;EUR;2018;FY;2018-12-31;2019-02-15;2021-03-02;539452560;539452560;3805700000;-1562800000;2242900000;1935000000;;;-737900000;4310100000;-415200000;-415000000;3894900000;-20600000;3874300000;-1471500000;2402800000;;2306500000;2266500000
VNA.DE;858328;EUR;2019;FY;2019-12-31;2020-02-15;2021-03-02;568267541;568267541;3421400000;-1660300000;1761100000;1679500000;;;-2175800000;3546300000;-384000000;-408600000;3162300000;-23400000;3138900000;-1844600000;1294300000;;1187000000;1147000000
VNA.DE;858328;EUR;2020;FY;2020-12-31;2021-02-15;2021-02-15;587128769;587128769;3733400000;-1729300000;2004100000;3306700000;;;-92300000;5473800000;-419400000;-389500000;5054400000;-40000000;5014400000;-1674400000;3340000000;;3268500000;3228500000
VOW.DE;858327;EUR;2016;FY;2016-12-31;2017-02-15;2018-02-15;501295263;501295263;217267000000;-176270000000;40997000000;-33894000000;-30036000000;;;7103000000;189000000;-1670000000;7292000000;;7292000000;-1912000000;5380000000;;5370000000;5145000000
VOW.DE;858327;EUR;2017;FY;2017-12-31;2018-02-15;2019-02-15;501295263;501295263;229550000000;-186001000000;43549000000;-29730000000;-28985000000;;;13819000000;-146000000;-1366000000;13673000000;;13673000000;-2210000000;11463000000;;11453000000;11179000000
VOW.DE;858327;EUR;2018;FY;2018-12-31;2019-02-15;2020-02-15;501295263;501295263;235849000000;-189500000000;46349000000;-32429000000;-29329000000;;;13920000000;1723000000;-580000000;15643000000;;15643000000;-3489000000;12154000000;;12137000000;11828000000
VOW.DE;858327;EUR;2019;FY;2019-12-31;2020-02-15;2021-04-26;501295263;501295263;252632000000;-203490000000;49142000000;-32182000000;-30745000000;;;16960000000;1396000000;-1614000000;18356000000;;18356000000;-4326000000;14030000000;;13887000000;13347000000
VOW.DE;858327;EUR;2020;FY;2020-12-31;2021-04-26;2022-02-15;501295263;501295263;222884000000;-183937000000;38947000000;-29272000000;-27806000000;;;9675000000;1991000000;-1498000000;11666000000;;11666000000;-2843000000;8823000000;;8866000000;8333000000
